A Beacon School - It's Late
Axel Thesleff - Bad Karma
Bag Raiders - Shooting Stars
Bloc Party - Flux
Bloc Party - Skeleton
Built to Spill - Cortez the Killer
Built to Spill - Lie for a Lie.mp4
Cassius - The Sound of Violence (Narcotic Thrust remix)
Chrome Sparks - Marijuana
Crystal Waters - Gypsy Woman
Culture Beat - Take Me Away (Hard to Be Hip mix)
Curtis Mayfield - Move on Up
Daft Punk - Random Access Memories (Vanderway Edit)
Denzel Curry - Ultimate
Doja Cat ft. SZA - Kiss Me More
Doves - There Goes the Fear (radio edit)
DyE - Fantasy
Empire of the Sun - Walking on a Dream
Field Music - In Context
filenames.txt
Frank Ocean - Chanel
Gui Boratto - Beautiful Life
Her's - What Once Was
Holograms - Fever
HOME - Resonance
Indeep - Last Night a DJ Saved My Life (Lemarquis remix)
Jack Stauber - Buttercup
Jakey - Not Dead Yet
Janet Jackson - Got 'til It's Gone (feat.Q-Tip & Joni Mitchell)
Joji - Sanctuary
Joy Again - Looking Out for You.m4a
Juice WRLD - Let Me Know (I Wonder Why Freestyle).m4a
Juice WRLD - Wishing Well
JVKE - Upside Down
K-Rino - Never Come Down
LCD Soundsystem - New York, I Love You But You're Bringing Me Down.flac
Mounika. - Cut My Hair (feat. Cavetown)
New Order - Temptation
Nicki Minaj - Good Form (feat. Lil Wayne)
Nujabes - The Final View
Oliver Cheatham - Get Down Saturday Night
Pearl Jam - Do the Evolution
Phantogram - When I'm Small
PinkPantheress - Just for me
PlayaPhonk - Phonky Town
Post Malone ft. Ty Dolla $ign - Psycho
Powfu & beabadoobee - death bed (coffee for your head)
R.L. Kelly - The Great Big World
Radical Face - Welcome Home, Son
Satellite Stories - Campfire
Sheck Wes - Mo Bamba
Ski Mask the Slump God - Nuketown (feat. Juice WRLD)
Surf Curse - In My Head Till I'm Dead.m4a
THE ANXIETY, WILLOW & Tyler Cole - Meet Me at Our Spot (live)
The Decemberists - The Rake's Song
The Drums - Money
The Hood Internet - Suit and Commercial
The Smiths - This Charming Man
Thundercat - Funny Thing
TWICE - FANCY
Two Door Cinema Club - Undercover Martyn.m4a
Warren Zevon - Lawyers, Guns and Money
We Were Promised Jetpacks - Act on Impulse
We Were Promised Jetpacks - Quiet Little Voices
WILLOW - Wait a Minute!
Xavier Rudd - Follow the Sun
